{
	"Map": [
		["W","W","W","W","W","W","W"," "," ","W","W","W","W","W","W","W"],
		["W"," "," "," "," "," "," "," "," "," "," "," "," "," "," ","W"],
		["W"," ","W","W","W"," "," "," "," "," "," ","W","W","W"," ","W"],
		["W"," ","W"," "," "," "," "," "," "," "," "," "," ","W"," ","W"],
		["W"," ","W"," "," "," "," "," "," "," "," "," "," ","W"," ","W"],
		["W"," "," "," "," ","W","W"," "," ","W","W"," "," "," "," ","W"],
		["W"," "," "," "," ","W"," "," "," "," ","W"," "," "," "," ","W"],
		["W"," "," "," "," "," "," "," "," "," "," "," "," "," "," ","W"],
		["W"," "," "," "," "," "," "," "," "," "," "," "," "," "," ","W"],
		["W"," "," "," "," ","W"," "," "," "," ","W"," "," "," "," ","W"],
		["W"," "," "," "," ","W","W"," "," ","W","W"," "," "," "," ","W"],
		["W"," ","W"," "," "," "," "," "," "," "," "," "," ","W"," ","W"],
		["W"," ","W"," "," "," "," "," "," "," "," "," "," ","W"," ","W"],
		["W"," ","W","W","W"," "," "," "," "," "," ","W","W","W"," ","W"],
		["W"," "," "," "," "," "," "," "," "," "," "," "," "," "," ","W"],
		["W","W","W","W","W","W","W","W","W","W","W","W","W","W","W","W"]
	],
	"Entities" : [
		["Chest", 8, 14, "shield"],
		["Button", 7, 14, "plain_01_btn"],

		["AreaTrigger", 7, 0, "start", 7, 14],
		["AreaTrigger", 8, 0, "start", 8, 14],

		["Zombie", 4, 8],
		["Zombie", 10, 8]
	],
	"Text": "You entered the shield dungeon!"
}
