{
	"Map": [
		["W","W","W","W","W","W","W","G"," ","W","W","W","W","W","W","W"],
		["W"," ","G"," ","G","G","G","G","G"," ","G"," ","G","G","G","W"],
		["W","G","G"," ","G"," ","G","G","G","G","G","G","G"," ","G","W"],
		["W","G"," "," ","G","G","G"," ","G","G"," ","G","G","G","G","W"],
		["W","G","G"," "," ","G"," ","G","G","G","G","G"," ","G"," ","W"],
		["W","G","G","G"," "," "," ","G"," ","G","G","G","G","G","G","W"],
		["W"," ","G","G","G"," ","G"," "," "," ","G","G","G"," ","G","W"],
		[" "," ","G"," ","G","G","G"," ","G"," ","G"," ","G","G","G","W"],
		[" ","G","G","G","G"," ","G"," "," ","G","G","G","G"," ","G","W"],
		["W","G"," ","G","G","G","G"," ","G","G"," ","G","G","G","G","W"],
		["W","G","G","G","G","G"," ","G","G","G","G","G"," ","G"," ","W"],
		["W","G","G","G","G","G","G","G"," ","G","G","G","G","G","G","W"],
		["W","G","G"," ","G"," "," ","G","G"," ","G","G","G"," ","G","W"],
		["W"," "," ","G","G","G"," ","G","G"," ","G"," ","G","G","G","W"],
		["W"," "," ","G","G"," "," ","G","G","G","G","G","G"," ","G","W"],
		["W","W","W","W","W","W","W"," "," ","W","W","W","W","W","W","W"]
	],
	"Entities": [
		["AreaTrigger", 7, 0, "sword_maze", 7, 14],
		["AreaTrigger", 8, 0, "sword_maze", 8, 14],

		["Bush", 7, 15, "shield_dungeon", 7, 1],
		["Bush", 8, 15, "shield_dungeon", 8, 1],

		["Door", 0, 7, "plain_01_btn", "plain_01", 14, 7],
		["Door", 0, 8, "plain_01_btn", "plain_01", 14, 8]
	],
	"Text": "You entered {MapSettings.WorldName} field!"
}
