{
	"Map": [
		["W","W","W","W","W","W","W"," "," ","W","W","W","W","W","W","W"],
		["W"," ","W"," "," "," "," "," "," ","W"," "," "," "," "," ","W"],
		["W"," ","W"," ","W"," ","W","W","W","W","W","W"," ","W"," ","W"],
		["W"," ","W"," ","W"," ","W"," ","W"," "," "," "," ","W"," ","W"],
		["W"," "," "," ","W"," "," "," ","W"," ","W","W"," ","W"," ","W"],
		["W","W","W","W","W","W","W"," ","W"," ","W"," "," ","W"," ","W"],
		["W"," "," "," "," "," ","W"," "," "," ","W","W","W","W"," ","W"],
		["W"," ","W","W","W"," ","W","W","W","W","W"," "," "," "," ","W"],
		["W"," ","W"," ","W"," "," "," "," "," ","W"," ","W","W"," ","W"],
		["W"," ","W"," ","W","W","W"," ","W","W","W"," "," ","W","W","W"],
		["W"," "," "," ","W"," ","W"," ","W"," ","W","W"," ","W"," ","W"],
		["W","W","W"," ","W"," "," "," "," "," "," ","W"," ","W"," ","W"],
		["W"," "," "," ","W","W","W","W","W","W"," ","W"," "," "," ","W"],
		["W"," ","W","W","W"," "," "," "," ","W"," ","W","W","W"," ","W"],
		["W"," "," "," "," "," ","W"," "," ","W"," "," "," "," "," ","W"],
		["W","W","W","W","W","W","W"," "," ","W","W","W","W","W","W","W"]
	],
	"Entities" : [
		["Chest", 8, 0, "sword"],

		["AreaTrigger", 7, 15, "start", 7, 1],
		["AreaTrigger", 8, 15, "start", 8, 1],

		["Heart", 1, 1],
		["Heart", 11, 5],
		["Heart", 14, 10],
		["Heart", 3, 8],
		["Heart", 5, 10]
	],
	"Text": "You entered the sword maze!"
}
